type octile
height 162
width 180
map
@@@@@@@@@@@@@@@@@@@@@@@@@@@@@@@@@@@@@@@@@@@@@@@@@@@@@@@@@@@@@@@@@@@@@@@@@@@@@@@@@@@@@@@@@@@@@@@@@@@@@@@@@@@@@@@@@@@@@@@@@@@@@@@@@@@@@@@@@@@@@@@@@@@@@@@@@@@@@@@@@@@@@@@@@@@@@@@@@@@@
@@@@@@@@@@@@@@@@@@@@@@@@@@@@@@@@@@@@@@@@@@@@@@@@@@@@@@@@@@@@@@@@@@@@@@@@@@@@@@@@@@@@@@@@@@@@@@@@@@@@@@@@@@@@@@@@@@@@@@@@@@@@@@@@@@@@@@@@@@@@@@@@@@@@@@@@@@@@@@@@@@@@@@@@@@@@@@@@@@@@
@@@@@@@@@@@@@@@@@@@@@@@@@@@@@@@@@@@@@@@@@@@@@@@@@@@@@@@@@@@@@@@@@@@@@@@@@@@@@@@@@@@@@@@@@@@@@@@@@@@@@@@@@@@@@@@@@@@@@@@@@@@@@@@@@@@@@@@@@@@@@@@@@@@@@@@@@@@@@@@@@@@@@@@@@@@@@@@@@@@@
@@@@@@@@@@@@@@@@@@@@@@@@@@@@@@@@@@@@@@@@@@@@@@@@@@@@@@@@@@@@@@@@@@@@@@@@@@@@@@@@@@@@@@@@@@@@@@@@@@@@@@@@@@@@@@@@@@@@@@@@@@@@@@@@@@@@@@@@@@@@@@@@@@@@@@@@@@@@@@@@@@@@@@@@@@@@@@@@@@@@
@@@@@@@@@@@@@@@@@@@@@@@@@@@@@@@@@@@@@@@@@@@@@@@@@@@@@@@@@@@@@@@@@@@@@@@@@@@@@@@@@@@@@@@@@@@@@@@@@@@@@@@@@@@@@@@@@@@@@@@@@@@@@@@@@@@@@@@@@@@@@@@@@@@@@@@@@@@@@@@@@@@@@@@@@@@@@@@@@@@@
@@@@@@@@@@@@@@@@@@@@@@@@@@@@@@@@@@@@@@@@@@@@@@@@@@@@@@@@@@@@@@@@@@@@@@@@@@@@@@@@@@@@@@@@@@@@@@@@@@@@@@@@@@@@@@@@@@@@@@@@@@@@@@@@@@@@@@@@@@@@@@@@@@@@@@@@@@@@@@@@@@@@@@@@@@@@@@@@@@@@
@@@@@@@@@@@@@@@@@@@@@@@@@@@@@@@@@@@@@@@@@@@@@@@@@@@@@@@@@@@@@@@@@@@@@@@@@@@@@@@@@@@@@@@@@@@@@@@@@@@@@@@@@@@@@@@@@@@@@@@@@@@@@@@@@@@@@@@@@@@@@@@@@@@@@@@@@@@@@@@@@@@@@@@@@@@@@@@@@@@@
@@@@@@@@@@@@@@@@@@@@@@@@@@@@@@@@@@@@@@@@@@@@@@@@@@@@@@@@@@@@@@@@@@@@@@@@@@@@@@@@@@@@@@@@@@@@@@@@@@@@@@@@@@@@@@@@@@@@@@@@@@@@@@@@@@@@@@@@@@@@@@@@@@@@@@@@@@@@@@@@@@@@@@@@@@@@@@@@@@@@
@@@@@@@@@@@@@@@@@@@@@@@@@@@@@@@@@@@@@@@@@@@@@@@@@@@@@@@@@@@@@@@@@@@@@@@@@@@@@@@@@@@@@@@@@@@@@@@@@@@@@@@@@@@@@@@@@@@@@@@@@@@@@@@@@@@@@@@@@@@@@@@@@@@@@@@@@@@@@@@@@@@@@@@@@@@@@@@@@@@@
@@@@@@@@@@@@@@@@@@@@@@@@@@@@@@@@@@@@@@@@@@@@@@@@@@@@@@@@@@@@@@@@@@@@@@@@@@@@@@@@@@@@@@@@@@@@@@@@@@@@@@@@@@@@@@@@@@@@@@@@@@@@@@@@@@@@@@@@@@@@@@@@@@@@@@@@@@@@@@@@@@@@@@@@@@@@@@@@@@@@
@@@@@@@@@@@@@@@@@@@@@@@@@@@@@@@@@@@@@@@@@@@@@@@@@@@@@@@@@@@@@@@@@@@@@@@@@@@@@@@@@@@@@@@@@@@@@@@@@@@@@@@@@@@@@@@@@@@@@@@@@@@@@@@@@@@@@@@@@@@@@@@@@@@@@@@@@@@@@@@@@@@@@@@@@@@@@@@@@@@@
@@@@@@@@@@@@@@@@@@@@@@@@@@@@@@@@@@@@@@@@@@@@@@@@@@@@@@@@@@@@@@@@@@@@@@@@@@@@@@@@@@@@@@@@@@@@@@@@@@@@@@@@@@@@@@@@@@@@@@@@@@@@@@@@@@@@@@@@@@@@@@@@@@@@@@@@@@@@@@@@@@@@@@@@@@@@@@@@@@@@
@@@@@@@@@@@@@@@@@@@@@@@@@@@@@@@@@@@@@@@@@@@@@@@@@@@@@@@@@@@@@@@@@@@@@@@@@@@@@@@@@@@@@@@@@@@@@@@@@@@@@@@@@@@@@@@@@@@@@@@@@@@@@@@@@@@@@@@@@@@@@@@@@@@@@@@@@@@@@@@@@@@@@@@@@@@@@@@@@@@@
@@@@@@@@@@@@@@@@@@@@@@@@@@@@@@@@@@@@@@@@@@@@@@@@@@@@@@@@@@@@@@@@@@@@@@@@@@@@@@@@@@@@@@@@@@@@@@@@@@@@@@@@@@@@@@@@@@@@@@@@@@@@@@@@@@@@@@@@@@@@@@@@@@@@@@@@@@@@@@@@@@@@@@@@@@@@@@@@@@@@
@@@@@@@@@@@@@@@@@@@@@@@@@@@@@@@@@@@@@@@@@@@@@@@@@@@@@@@@@@@@@@@@@@@@@@@@@@@@@@@@@@@@@@@@@@@@@@@@@@@@@@@@@@@@@@@@@@@@@@@@@@@@@@@@@@@@@@@@@@@@@@@@@@@@@@@@@@@@@@@@@@@@@@@@@@@@@@@@@@@@
@@@@@@@@@@@@@@@@@@@@@@@@@@@@@@@@@@@@@@@@@@@@@@@@@@@@@@@@@@@@@@@@@@@@@@@@@@@@@@@@@@@@@@@@@@@@@@@@@@@@@@@@@@@@@@@@@@@@@@@@@@@@@@@@@@@@@@@@@@@@@@@@@@@@@@@@@@@@@@@@@@@@@@@@@@@@@@@@@@@@
@@@@@@@@@@@@@@@@@@@@@@@@@@@@@@@@@@@@@@@@@@@@@@@@@@@@@@@@@@@@@@@@@@@@@@@@@@@@@@@@@@@@@@@@@@@@@@@@@@@@@@@@@@@@@@@@@@@@@@@@@@@@@@@@@@@@@@@@@@@@@@@@@@@@@@@@@@@@@@@@@@@@@@@@@@@@@@@@@@@@
@@@@@@@@@@@@@@@@@@@@@@@@@@@@@@@@@@@@@@@@@@@@@@@@@@@@@@@@@@@@@@@@@@@@@@@@@@@@@@@@@@@@@@@@@@@@@@@@@@@@@@@@@@@@@@@@@@@@@@@@@@@@@@@@@@@@@@@@@@@@@@@@@@@@@@@@@@@@@@@@@@@@@@@@@@@@@@@@@@@@
@@@@@@@@@@@@@@@@@@@@@@@@@@@@@@@@@@@@@@@@@@@@@@@@@@@@@@@@@@@@@@@@@@@@@@@@@@@@@@@@@@@@@@@@@@@@@@@@@@@@@@@@@@@@@@@@@@@@@@@@@@@@@@@@@@@@@@@@@@@@@@@@@@@@@@@@@@@@@@@@@@@@@@@@@@@@@@@@@@@@
@@@@@@@@@@@@@@@@@@@@@@@@@@@@@@@@@@@@@@@@@@@@@@@@@@@@@@@@@@@@@@@@@@@@@@@@@@@@@@@@@@@@@@@@@@@@@@@@@@@@@@@@@@@@@@@@@@@@@@@@@@@@@@@@@@@@@@@@@@@@@@@@@@@@@@@@@@@@@@@@@@@@@@@@@@@@@@@@@@@@
@@@@@@@@@@@@@@@@@@@@@@@@@@@@@@@@@@@@@@@@@@@@@@@@@@@@@@@@@@@@@@@@@@@@@@@@@@@@@@@@@@@@@@@@@@@@@@@@@@@@@@@@@@@@@@@@@@@@@@@@@@@@@@@@@@@@@@@@@@@@@@@@@@@@@@@@@@@@@@@@@@@@@@@@@@@@@@@@@@@@
@@@@@@@@@@@@@@@@@@@@@@@@@@@@@@@@@@@@@@@@@@@@@@@@@@@@@@@@@@@@@@@@@@@@@@@@@@@@@@@@@@@@@@@@@@@@@@@@@@@@@@@@@@@@@@@@@@@@@@@@@@@@@@@@@@@@@@@@@@@@@@@@@@@@@@@@@@@@@@@@@@@@@@@@@@@@@@@@@@@@
@@@@@@@@@@@@@@@@@@@@@@@@@@@@@@@@@@@@@@@@@@@@@@@@@@@@@@@@@@@@@@@@@@@@@@@@@@@@@@@@@@@@@@@@@@@@@@@@@@@@@@@@@@@@@@@@@@@@@@@@@@@@@@@@@@@@@@@@@@@@@@@@@@@@@@@@@@@@@@@@@@@@@@@@@@@@@@@@@@@@
@@@@@@@@@@@@@@@@@@@@@@@@@@@@@@@@@@@@@@@@@@@@@@@@@@@@@@@@@@@@@@@@@@@@@@@@@@@@@@@@@@@@@@@@@@@@@@@@@@@@@@@@@@@@@@@@@@@@@@@@@@@@@@@@@@@@@@@@@@@@@@@@@@@@@@@@@@@@@@@@@@@@@@@@@@@@@@@@@@@@
@@@@@@@@@@@@@@@@@@@@@@@@@@@@@@@@@@@@@@@@@@@@@@@@@@@@@@@@@@@@@@@@@@@@@@@@@@@@@@@@@@@@@@@@@@@@@@@@@@@@@@@@@@@@@@@@@@@@@@@@@@@@@@@@@@@@@@@@@@@@@@@@@@@@@@@@@@@@@@@@@@@@@@@@@@@@@@@@@@@@
@@@@@@@@@@@@@@@@@@@@@@@@@@@@@@@@@@@@@@@@@@@@@@@@@@@@@@@@@@@@@@@@@@@@@@@@@@@@@@@@@@@@@@@@@@@@@@@@@@@@@@@@@@@@@@@@@@@@@@@@@@@@@@@@@@@@@@@@@@@@@@@@@@@@@@@@@@@@@@@@@@@@@@@@@@@@@@@@@@@@
@@@@@@@@@@@@@@@@@@@@@@@@@@@@@@@@@@@@@@@@@@@@@@@@@@@@@@@@@@@@@@@@@@@@@@@@@@@@@@@@@@@@@@@@@@@@@@@@@@@@@@@@@@@@@@@@@@@@@@@@@@@@@@@@@@@@@@@@@@@@@@@@@@@@@@@@@@@@@@@@@@@@@@@@@@@@@@@@@@@@
@@@@@@@@@@@@@@@@@@@@@@@@@@@@@@@@@@@@@@@@@@@@@@@@@@@@@@@@@@@@@@@@@@...................................................@@@@@@@@@@@@@@@@@@@@@@@@@@@@@@@@@@@@@@@@@@@@@@@@@@@@@@@@@@@@@@@
@@@@@@@@@@@@@@@@@@@@@@@@@@@@@@@@@@@@@@@@@@@@@@@@@@@@@@@@@@@@@@@@@@...................................................@@@@@@@@@@@@@@@@@@@@@@@@@@@@@@@@@@@@@@@@@@@@@@@@@@@@@@@@@@@@@@@
@@@@@@@@@@@@@@@@@@@@@@@@@@@@@@@@@@@@@@@@@@@@@@@@@@@@@@@@@@@@@@@@@@...................................................@@@@@@@@@@@@@@@@@@@@@@@@@@@@@@@@@@@@@@@@@@@@@@@@@@@@@@@@@@@@@@@
@@@@@@@@@@@@@@@@@@@@@@@@@@@@@@@@@@@@@@@@@@@@@@@@@@@@@@@@@.....................................................................@@@@@@@@@@@@@@@@@@@@@@@@@@@@@@@@@@@@@@@@@@@@@@@@@@@@@@
@@@@@@@@@@@@@@@@@@@@@@@@@@@@@@@@@@@@@@@@@@@@@@@@@@@@@@@@@.....................................................................@@@@@@@@@@@@@@@@@@@@@@@@@@@@@@@@@@@@@@@@@@@@@@@@@@@@@@
@@@@@@@@@@@@@@@@@@@@@@@@@@@@@@@@@@@@@@@@@@@@@@@@@@@@@@@@@.....................................................................@@@@@@@@@@@@@@@@@@@@@@@@@@@@@@@@@@@@@@@@@@@@@@@@@@@@@@
@@@@@@@@@@@@@@@@@@@@@@@@@@@@@@@@@@@@@@@@@@@@@@@@@@@.................................................................................@@@@@@@@@@@@@@@@@@@@@@@@@@@@@@@@@@@@@@@@@@@@@@@@
@@@@@@@@@@@@@@@@@@@@@@@@@@@@@@@@@@@@@@@@@@@@@@@@@@@.................................................................................@@@@@@@@@@@@@@@@@@@@@@@@@@@@@@@@@@@@@@@@@@@@@@@@
@@@@@@@@@@@@@@@@@@@@@@@@@@@@@@@@@@@@@@@@@@@@@@@@@@@.................................................................................@@@@@@@@@@@@@@@@@@@@@@@@@@@@@@@@@@@@@@@@@@@@@@@@
@@@@@@@@@@@@@@@@@@@@@@@@@@@@@@@@@@@@@@@@@@@@@.............................................................................................@@@@@@@@@@@@@@@@@@@@@@@@@@@@@@@@@@@@@@@@@@
@@@@@@@@@@@@@@@@@@@@@@@@@@@@@@@@@@@@@@@@@@@@@.............................................................................................@@@@@@@@@@@@@@@@@@@@@@@@@@@@@@@@@@@@@@@@@@
@@@@@@@@@@@@@@@@@@@@@@@@@@@@@@@@@@@@@@@@@@@@@.............................................................................................@@@@@@@@@@@@@@@@@@@@@@@@@@@@@@@@@@@@@@@@@@
@@@@@@@@@@@@@@@@@@@@@@@@@@@@@@@@@@@@@@@......................................................................................................@@@@@@@@@@@@@@@@@@@@@@@@@@@@@@@@@@@@@@@
@@@@@@@@@@@@@@@@@@@@@@@@@@@@@@@@@@@@@@@......................................................................................................@@@@@@@@@@@@@@@@@@@@@@@@@@@@@@@@@@@@@@@
@@@@@@@@@@@@@@@@@@@@@@@@@@@@@@@@@@@@@@@......................................................................................................@@@@@@@@@@@@@@@@@@@@@@@@@@@@@@@@@@@@@@@
@@@@@@@@@@@@@@@@@@@@@@@@@@@@@@@@@@@@............................................................................................................@@@@@@@@@@@@@@@@@@@@@@@@@@@@@@@@@@@@
@@@@@@@@@@@@@@@@@@@@@@@@@@@@@@@@@@@@............................................................................................................@@@@@@@@@@@@@@@@@@@@@@@@@@@@@@@@@@@@
@@@@@@@@@@@@@@@@@@@@@@@@@@@@@@@@@@@@............................................................................................................@@@@@@@@@@@@@@@@@@@@@@@@@@@@@@@@@@@@
@@@@@@@@@@@@@@@@@@@@@@@@@@@@@@@@@.............................................@@@@@@@@@@@@.........................................................@@@@@@@@@@@@@@@@@@@@@@@@@@@@@@@@@
@@@@@@@@@@@@@@@@@@@@@@@@@@@@@@@@@.............................................@@@@@@@@@@@@.........................................................@@@@@@@@@@@@@@@@@@@@@@@@@@@@@@@@@
@@@@@@@@@@@@@@@@@@@@@@@@@@@@@@@@@.............................................@@@@@@@@@@@@.........................................................@@@@@@@@@@@@@@@@@@@@@@@@@@@@@@@@@
@@@@@@@@@@@@@@@@@@@@@@@@@@@@@@..................@@@@@@........................@@@@@@@@@@@@@@@@@@@@@...................................................@@@@@@@@@@@@@@@@@@@@@@@@@@@@@@
@@@@@@@@@@@@@@@@@@@@@@@@@@@@@@..................@@@@@@........................@@@@@@@@@@@@@@@@@@@@@...................................................@@@@@@@@@@@@@@@@@@@@@@@@@@@@@@
@@@@@@@@@@@@@@@@@@@@@@@@@@@@@@..................@@@@@@........................@@@@@@@@@@@@@@@@@@@@@...................................................@@@@@@@@@@@@@@@@@@@@@@@@@@@@@@
@@@@@@@@@@@@@@@@@@@@@@@@@@@..................@@@@@@@@@............@@@..................@@@@@@@@@@@@......................................................@@@@@@@@@@@@@@@@@@@@@@@@@@@
@@@@@@@@@@@@@@@@@@@@@@@@@@@..................@@@@@@@@@............@@@..................@@@@@@@@@@@@......................................................@@@@@@@@@@@@@@@@@@@@@@@@@@@
@@@@@@@@@@@@@@@@@@@@@@@@@@@..................@@@@@@@@@............@@@..................@@@@@@@@@@@@......................................................@@@@@@@@@@@@@@@@@@@@@@@@@@@
@@@@@@@@@@@@@@@@@@@@@@@@..................@@@@@@@@@...............@@@.......................................................................................@@@@@@@@@@@@@@@@@@@@@@@@
@@@@@@@@@@@@@@@@@@@@@@@@..................@@@@@@@@@...............@@@.......................................................................................@@@@@@@@@@@@@@@@@@@@@@@@
@@@@@@@@@@@@@@@@@@@@@@@@..................@@@@@@@@@...............@@@.......................................................................................@@@@@@@@@@@@@@@@@@@@@@@@
@@@@@@@@@@@@@@@@@@@@@..................@@@@@@@@@......................................................@@@@@@...............@@@.................................@@@@@@@@@@@@@@@@@@@@@
@@@@@@@@@@@@@@@@@@@@@..................@@@@@@@@@......................................................@@@@@@...............@@@.................................@@@@@@@@@@@@@@@@@@@@@
@@@@@@@@@@@@@@@@@@@@@..................@@@@@@@@@......................................................@@@@@@...............@@@.................................@@@@@@@@@@@@@@@@@@@@@
@@@@@@@@@@@@@@@@@@..................@@@@@@@@@......................................................@@@@@@@@@@@@............@@@.................................@@@@@@@@@@@@@@@@@@@@@
@@@@@@@@@@@@@@@@@@..................@@@@@@@@@......................................................@@@@@@@@@@@@............@@@.................................@@@@@@@@@@@@@@@@@@@@@
@@@@@@@@@@@@@@@@@@..................@@@@@@@@@......................................................@@@@@@@@@@@@............@@@.................................@@@@@@@@@@@@@@@@@@@@@
@@@@@@@@@@@@@@@@@@.....................@@@...............................................................@@@@@@@@@@@@.............................................@@@@@@@@@@@@@@@@@@
@@@@@@@@@@@@@@@@@@.....................@@@...............................................................@@@@@@@@@@@@.............................................@@@@@@@@@@@@@@@@@@
@@@@@@@@@@@@@@@@@@.....................@@@...............................................................@@@@@@@@@@@@.............................................@@@@@@@@@@@@@@@@@@
@@@@@@@@@@@@@@@.............................................................................................@@@@@@@@@@@@...........................@@@............@@@@@@@@@@@@@@@@@@
@@@@@@@@@@@@@@@.............................................................................................@@@@@@@@@@@@...........................@@@............@@@@@@@@@@@@@@@@@@
@@@@@@@@@@@@@@@.............................................................................................@@@@@@@@@@@@...........................@@@............@@@@@@@@@@@@@@@@@@
@@@@@@@@@@@@@@@................................................................................................@@@..............................@@@@@@@@@............@@@@@@@@@@@@@@@
@@@@@@@@@@@@@@@................................................................................................@@@..............................@@@@@@@@@............@@@@@@@@@@@@@@@
@@@@@@@@@@@@@@@................................................................................................@@@..............................@@@@@@@@@............@@@@@@@@@@@@@@@
@@@@@@@@@@@@...............................................................................................................@@@.....................@@@@@@@@@............@@@@@@@@@@@@
@@@@@@@@@@@@...............................................................................................................@@@.....................@@@@@@@@@............@@@@@@@@@@@@
@@@@@@@@@@@@...............................................................................................................@@@.....................@@@@@@@@@............@@@@@@@@@@@@
@@@@@@@@@@@@..................................................................@@@@@@....................................@@@@@@@@@@@@@@@...............@@@@@@@@@...@@@...@@@@@@@@@@@@
@@@@@@@@@@@@..................................................................@@@@@@....................................@@@@@@@@@@@@@@@...............@@@@@@@@@...@@@...@@@@@@@@@@@@
@@@@@@@@@@@@..................................................................@@@@@@....................................@@@@@@@@@@@@@@@...............@@@@@@@@@...@@@...@@@@@@@@@@@@
@@@@@@@@@@@@...............................................................@@@@@@@@@@@@@@@@@@........................@@@@@@@@@@@@@@@@@@@@@...............@@@@@@@@@@@@...@@@@@@@@@@@@
@@@@@@@@@@@@...............................................................@@@@@@@@@@@@@@@@@@........................@@@@@@@@@@@@@@@@@@@@@...............@@@@@@@@@@@@...@@@@@@@@@@@@
@@@@@@@@@@@@...............................................................@@@@@@@@@@@@@@@@@@........................@@@@@@@@@@@@@@@@@@@@@...............@@@@@@@@@@@@...@@@@@@@@@@@@
@@@@@@@@@@@@..................................................................@@@@@@@@@@@@@@@@@@.................................@@@@@@..................@@@@@@@@@@@@@@@@@@@@@@@@@@@
@@@@@@@@@@@@..................................................................@@@@@@@@@@@@@@@@@@.................................@@@@@@..................@@@@@@@@@@@@@@@@@@@@@@@@@@@
@@@@@@@@@@@@..................................................................@@@@@@@@@@@@@@@@@@.................................@@@@@@..................@@@@@@@@@@@@@@@@@@@@@@@@@@@
@@@@@@@@@@@@........................................................................@@@@@@..................................................................@@@@@@@@@@@@@@@@@@@@@@@@
@@@@@@@@@@@@........................................................................@@@@@@..................................................................@@@@@@@@@@@@@@@@@@@@@@@@
@@@@@@@@@@@@........................................................................@@@@@@..................................................................@@@@@@@@@@@@@@@@@@@@@@@@
@@@@@@@@@@@@.....................@@@@@@.....................................................................................................................@@@@@@@@@@@@@@@@@@@@@@@@
@@@@@@@@@@@@.....................@@@@@@.....................................................................................................................@@@@@@@@@@@@@@@@@@@@@@@@
@@@@@@@@@@@@.....................@@@@@@.....................................................................................................................@@@@@@@@@@@@@@@@@@@@@@@@
@@@@@@@@@@@@........................@@@........................................................................................................................@@@@@@@@@@@@@@@@@@@@@
@@@@@@@@@@@@........................@@@........................................................................................................................@@@@@@@@@@@@@@@@@@@@@
@@@@@@@@@@@@........................@@@........................................................................................................................@@@@@@@@@@@@@@@@@@@@@
@@@@@@@@@@@@......................................................@@@@@@@@@.......................................................................................@@@@@@@@@@@@@@@@@@
@@@@@@@@@@@@......................................................@@@@@@@@@.......................................................................................@@@@@@@@@@@@@@@@@@
@@@@@@@@@@@@......................................................@@@@@@@@@.......................................................................................@@@@@@@@@@@@@@@@@@
@@@@@@@@@@@@...@@@@@@...........................@@@@@@.........@@@@@@@@@@@@@@@...............@@@........................................................................@@@@@@@@@@@@
@@@@@@@@@@@@...@@@@@@...........................@@@@@@.........@@@@@@@@@@@@@@@...............@@@........................................................................@@@@@@@@@@@@
@@@@@@@@@@@@...@@@@@@...........................@@@@@@.........@@@@@@@@@@@@@@@...............@@@........................................................................@@@@@@@@@@@@
@@@@@@@@@@@@@@@@@@@@@@@@.....................@@@@@@@@@@@@............@@@@@@@@@@@@@@@......@@@@@@........................................................................@@@@@@@@@@@@
@@@@@@@@@@@@@@@@@@@@@@@@.....................@@@@@@@@@@@@............@@@@@@@@@@@@@@@......@@@@@@........................................................................@@@@@@@@@@@@
@@@@@@@@@@@@@@@@@@@@@@@@.....................@@@@@@@@@@@@............@@@@@@@@@@@@@@@......@@@@@@........................................................................@@@@@@@@@@@@
@@@@@@@@@@@@@@@@@@@@@@@@@@@..................@@@@@@@@@@@@..................@@@@@@@@@............................................................@@@.....................@@@@@@@@@@@@
@@@@@@@@@@@@@@@@@@@@@@@@@@@..................@@@@@@@@@@@@..................@@@@@@@@@............................................................@@@.....................@@@@@@@@@@@@
@@@@@@@@@@@@@@@@@@@@@@@@@@@..................@@@@@@@@@@@@..................@@@@@@@@@............................................................@@@.....................@@@@@@@@@@@@
@@@@@@@@@@@@...@@@@@@@@@..................@@@@@@@@@@@@@@@.....................@@@...............................................................@@@@@@..................@@@@@@@@@@@@
@@@@@@@@@@@@...@@@@@@@@@..................@@@@@@@@@@@@@@@.....................@@@...............................................................@@@@@@..................@@@@@@@@@@@@
@@@@@@@@@@@@...@@@@@@@@@..................@@@@@@@@@@@@@@@.....................@@@...............................................................@@@@@@..................@@@@@@@@@@@@
@@@@@@@@@@@@......@@@@@@........................@@@...@@@@@@............................................................................................................@@@@@@@@@@@@
@@@@@@@@@@@@......@@@@@@........................@@@...@@@@@@............................................................................................................@@@@@@@@@@@@
@@@@@@@@@@@@......@@@@@@........................@@@...@@@@@@............................................................................................................@@@@@@@@@@@@
@@@@@@@@@@@@......................................................................................................@@@@@@................................................@@@@@@@@@@@@
@@@@@@@@@@@@......................................................................................................@@@@@@................................................@@@@@@@@@@@@
@@@@@@@@@@@@......................................................................................................@@@@@@................................................@@@@@@@@@@@@
@@@@@@@@@@@@...................................................................................................@@@@@@@@@...........................@@@@@@...............@@@@@@@@@@@@
@@@@@@@@@@@@...................................................................................................@@@@@@@@@...........................@@@@@@...............@@@@@@@@@@@@
@@@@@@@@@@@@...................................................................................................@@@@@@@@@...........................@@@@@@...............@@@@@@@@@@@@
@@@@@@@@@@@@...................................................................................................@@@@@@@@@@@@.....................@@@@@@@@@@@@............@@@@@@@@@@@@
@@@@@@@@@@@@...................................................................................................@@@@@@@@@@@@.....................@@@@@@@@@@@@............@@@@@@@@@@@@
@@@@@@@@@@@@...................................................................................................@@@@@@@@@@@@.....................@@@@@@@@@@@@............@@@@@@@@@@@@
@@@@@@@@@@@@@@@.............................................................................................@@@@@@@@@@@@........................@@@@@@@@@@@@............@@@@@@@@@@@@
@@@@@@@@@@@@@@@.............................................................................................@@@@@@@@@@@@........................@@@@@@@@@@@@............@@@@@@@@@@@@
@@@@@@@@@@@@@@@.............................................................................................@@@@@@@@@@@@........................@@@@@@@@@@@@............@@@@@@@@@@@@
@@@@@@@@@@@@@@@......................................................................................................@@@.....................@@@@@@@@@@@@@@@............@@@@@@@@@@@@
@@@@@@@@@@@@@@@......................................................................................................@@@.....................@@@@@@@@@@@@@@@............@@@@@@@@@@@@
@@@@@@@@@@@@@@@......................................................................................................@@@.....................@@@@@@@@@@@@@@@............@@@@@@@@@@@@
@@@@@@@@@@@@@@@@@@...............@@@@@@............................................................................................................@@@@@@@@@@@@.........@@@@@@@@@@@@
@@@@@@@@@@@@@@@@@@...............@@@@@@............................................................................................................@@@@@@@@@@@@.........@@@@@@@@@@@@
@@@@@@@@@@@@@@@@@@...............@@@@@@............................................................................................................@@@@@@@@@@@@.........@@@@@@@@@@@@
@@@@@@@@@@@@@@@@@@............@@@@@@@@@@@@..............................................................................................................................@@@@@@@@@@@@
@@@@@@@@@@@@@@@@@@............@@@@@@@@@@@@..............................................................................................................................@@@@@@@@@@@@
@@@@@@@@@@@@@@@@@@............@@@@@@@@@@@@..............................................................................................................................@@@@@@@@@@@@
@@@@@@@@@@@@@@@@@@@@@......@@@@@@@@@@@@@@@@@@........................................................................................................................@@@@@@@@@@@@@@@
@@@@@@@@@@@@@@@@@@@@@......@@@@@@@@@@@@@@@@@@........................................................................................................................@@@@@@@@@@@@@@@
@@@@@@@@@@@@@@@@@@@@@......@@@@@@@@@@@@@@@@@@........................................................................................................................@@@@@@@@@@@@@@@
@@@@@@@@@@@@@@@@@@@@@............@@@@@@@@@@@@.....................................................................................................................@@@@@@@@@@@@@@@@@@
@@@@@@@@@@@@@@@@@@@@@............@@@@@@@@@@@@.....................................................................................................................@@@@@@@@@@@@@@@@@@
@@@@@@@@@@@@@@@@@@@@@............@@@@@@@@@@@@.....................................................................................................................@@@@@@@@@@@@@@@@@@
@@@@@@@@@@@@@@@@@@@@@@@@............@@@@@@..........................................................................................@@@@@@@@@@@@..................@@@@@@@@@@@@@@@@@@
@@@@@@@@@@@@@@@@@@@@@@@@............@@@@@@..........................................................................................@@@@@@@@@@@@..................@@@@@@@@@@@@@@@@@@
@@@@@@@@@@@@@@@@@@@@@@@@............@@@@@@..........................................................................................@@@@@@@@@@@@..................@@@@@@@@@@@@@@@@@@
@@@@@@@@@@@@@@@@@@@@@@@@............................................................................................................@@@@@@@@@@@@...............@@@@@@@@@@@@@@@@@@@@@
@@@@@@@@@@@@@@@@@@@@@@@@............................................................................................................@@@@@@@@@@@@...............@@@@@@@@@@@@@@@@@@@@@
@@@@@@@@@@@@@@@@@@@@@@@@............................................................................................................@@@@@@@@@@@@...............@@@@@@@@@@@@@@@@@@@@@
@@@@@@@@@@@@@@@@@@@@@@@@@@@...........................@@@........................................................................@@@@@@@@@@@@@@@............@@@@@@@@@@@@@@@@@@@@@@@@
@@@@@@@@@@@@@@@@@@@@@@@@@@@...........................@@@........................................................................@@@@@@@@@@@@@@@............@@@@@@@@@@@@@@@@@@@@@@@@
@@@@@@@@@@@@@@@@@@@@@@@@@@@...........................@@@........................................................................@@@@@@@@@@@@@@@............@@@@@@@@@@@@@@@@@@@@@@@@
@@@@@@@@@@@@@@@@@@@@@@@@@@@...........................@@@@@@.......................................@@@@@@................................................@@@@@@@@@@@@@@@@@@@@@@@@@@@
@@@@@@@@@@@@@@@@@@@@@@@@@@@...........................@@@@@@.......................................@@@@@@................................................@@@@@@@@@@@@@@@@@@@@@@@@@@@
@@@@@@@@@@@@@@@@@@@@@@@@@@@...........................@@@@@@.......................................@@@@@@................................................@@@@@@@@@@@@@@@@@@@@@@@@@@@
@@@@@@@@@@@@@@@@@@@@@@@@@@@@@@..................................................................@@@@@@@@@@@@..........................................@@@@@@@@@@@@@@@@@@@@@@@@@@@@@@
@@@@@@@@@@@@@@@@@@@@@@@@@@@@@@..................................................................@@@@@@@@@@@@..........................................@@@@@@@@@@@@@@@@@@@@@@@@@@@@@@
@@@@@@@@@@@@@@@@@@@@@@@@@@@@@@..................................................................@@@@@@@@@@@@..........................................@@@@@@@@@@@@@@@@@@@@@@@@@@@@@@
@@@@@@@@@@@@@@@@@@@@@@@@@@@@@@@@@@@@............................................................@@@@@@@@@@@@............@@@@@@.....................@@@@@@@@@@@@@@@@@@@@@@@@@@@@@@@@@
@@@@@@@@@@@@@@@@@@@@@@@@@@@@@@@@@@@@............................................................@@@@@@@@@@@@............@@@@@@.....................@@@@@@@@@@@@@@@@@@@@@@@@@@@@@@@@@
@@@@@@@@@@@@@@@@@@@@@@@@@@@@@@@@@@@@............................................................@@@@@@@@@@@@............@@@@@@.....................@@@@@@@@@@@@@@@@@@@@@@@@@@@@@@@@@
@@@@@@@@@@@@@@@@@@@@@@@@@@@@@@@@@@@@@@@@@@......................................................@@@@@@@@@@@@@@@..............................@@@@@@@@@@@@@@@@@@@@@@@@@@@@@@@@@@@@@@@
@@@@@@@@@@@@@@@@@@@@@@@@@@@@@@@@@@@@@@@@@@......................................................@@@@@@@@@@@@@@@..............................@@@@@@@@@@@@@@@@@@@@@@@@@@@@@@@@@@@@@@@
@@@@@@@@@@@@@@@@@@@@@@@@@@@@@@@@@@@@@@@@@@......................................................@@@@@@@@@@@@@@@..............................@@@@@@@@@@@@@@@@@@@@@@@@@@@@@@@@@@@@@@@
@@@@@@@@@@@@@@@@@@@@@@@@@@@@@@@@@@@@@@@@@@@@@@@@@@@@@@@@@@@@@@@@@@@@@@@@@@@@@@@@@@@@@@@@@@@@@@@@@@@@@@@@@@@@@@@@@@@@@@@@@@@@@@@@@@@@@@@@@@@@@@@@@@@@@@@@@@@@@@@@@@@@@@@@@@@@@@@@@@@@
@@@@@@@@@@@@@@@@@@@@@@@@@@@@@@@@@@@@@@@@@@@@@@@@@@@@@@@@@@@@@@@@@@@@@@@@@@@@@@@@@@@@@@@@@@@@@@@@@@@@@@@@@@@@@@@@@@@@@@@@@@@@@@@@@@@@@@@@@@@@@@@@@@@@@@@@@@@@@@@@@@@@@@@@@@@@@@@@@@@@
@@@@@@@@@@@@@@@@@@@@@@@@@@@@@@@@@@@@@@@@@@@@@@@@@@@@@@@@@@@@@@@@@@@@@@@@@@@@@@@@@@@@@@@@@@@@@@@@@@@@@@@@@@@@@@@@@@@@@@@@@@@@@@@@@@@@@@@@@@@@@@@@@@@@@@@@@@@@@@@@@@@@@@@@@@@@@@@@@@@@
