type octile
height 11
width 25
map
WWWWWWWWWWWWWWWWWWWWWWWWW
WW.......WWWWWW.........W
W......W..WWWWW.........W
W.........WWWWW.W......WW
W..WWWW...............W.W
W..WWWW...TTTTT.W....WW.W
W..WWWW...TTTTT.....WW..W
W..................WW...W
W.......................W
WW.......WWWWWW.........W
WWWWWWWWWWWWWWWWWWWWWWWWW